10
-.-.-.-.-.-.-.-.-.-
-.-.-.-.-.-.-.-.-.-
-.-.-.-.-.W.-.-.-.-
-.-.-.-.-.-.-.-.-.-
-.-.-.-.-.-.-.-.-.G
-.-.-.-.-.-.-.-.-.-
-.-.-.-.-.-.-.-.-.-
-.-.-.-.-.-.-.-.-.-
-.-.-.-.-.-.-.-.-.-
-.-.-.-.-.-.-.-.-.-